###############
#A XX#XXXXXX B#
# XXXX5X#XXXX #
##XXX#XXXXXX#X#
#XXXXX#X#XXXXX#
##XXX#XXXXXX#X#
##XXX#XXXXXX#X#
#XXX6X#X#XXXXX#
#X#XXXXXXXXXX4#
#XXX#XXXX#XX#X#
#XXXXX4X#XXXXX#
##XXX#X6XXXX#X#
# XX#XXXX#XX# #
#D XX#XXXXXX C#
###############
